R 750 500
SO textures/greystone.xpm
EA textures/mossy.xpm
WE textures/rainbow.xpm
S textures/stick_figure.xpm
C 51, 204, 255
F 71, 209, 71
NO textures/stripes.xpm

111111111111
100000000001
100020002001
100000000001
100000N00001
102000000001
102000000001
102000000001
100000002001
100000000001
111111111111
