R 1920 1080
SO textures/colorstone.xpm

EA textures/greystone.xpm

WE textures/stripes.xpm
S textures/stick_figure.xpm
C 51, 204, 255
F 71, 209, 71
NO textures/rainbow.xpm

11111111111111111
10222202000000001
1000000000E000001
100000000000000011111111111111111111
100000222220002000000000000000000001
100000000000000011111111111111111111
10002000000000201
11111111111111111
